turn out	оказаться
temporary	временный
occure	случаться, происходить
template	образец, шаблон
suppose	полагать
apologize	извиняться
get on with	ладить с кем-то
end up	оказаться
treat	лечить, обращаться с кем-либо
neat	аккуратный
generous	щедрый
accurate	точный
curly	кудрявый
bald	лысый
spark	искриться
awful	ужасный
suddenly	внезапно, вдруг
realize	осознать
hardly ever	почти никогда
embarrass	смущать
shy	застенчивый
mean	скупой, жадный
eventually	в конце концов
fur	мех
put on (off)	надевать (снимать)
wool	шерсть
coat	пальто
skirt	юбка
interact	взаимодействовать
socks	носки
suit	костюм
tights	колготки
trousers	брюки
belt	ремень
gloves	перчатки
dress	платье
attractive	привлекательный
tracksuit	спортивный костюм
contraction	сокращение
admire	восхищаться
hire	нанимать
inspire	вдохновлять
although	хотя
carry	нести
certain	определенный
attempt	попытка, пытаться
admit	признавать, допускать
above	выше, над
behind	позади
rope	веревка
attic	чердак, мансарда
sightseeing	осмотр достопримечательностей
put through	связаться с кем-то
bother	беспокоить
remind	напоминать
to get lost	потеряться, заблудиться
on your own	делать самому
foggy	туманный
crowd(ed)	толпа (переполненный)
pity	жалость
destiny	судьба
entire	полный, целый, весь
fate	судьба
divinity	божественность
confidence	уверенность
sense	смысл, чувство
immediately	немедленно
advert	реклама
roof	крыша
shelf	полка
ask for	попросить
spend on	тратить на
belong to	принадлежать кому-то
arrange	организовывать
noun	существительное
adjective	прилагательное
verb	глагол
prepositions	предлоги
conjuction	союз, соединение
link	связывать
refer	ссылаться
express	выражать
order	порядок, приказ
to get married	жениться
to be in hurry	спешить
injury	травма
revise	проверять, исправлять
issue	выпуск, выдача
resume	возобновлять
undo	отменить
election	выборы
trolley	тележка
departure	отправление
reclaim	исправление
baggage reclaim	выдача багажа
claim	требовать, клеймить, заявлять, претензия
vice versa	наоборот
jewellery	ювелирные изделия
excite	возбуждать, волновать
evidence	доказательство
patience	терпение
appointment	назначенная встреча
consonant	согласный
vowel	гласный
surgeron	хирург
cross out	вычеркивать
parcel	посылка
purse	кошелек
turn on (off)	включать (выключать)
gather	cобирать, встреча
purpose	цель, намерение
wish	желание
bill	счет
tips	чаевые
still	спокойный
impression	впечатление
laundry	стирка
strive	стремиться
coal	уголь
argue	спорить, ссориться, заявить
recently	недавно
credentials	полномочия, учетные данные
brackets	скобки
yet	еще
stool	табуретки
try on	примерять
fit	подходить по размеру
suit	подходить, быть к лицу
otherwise	в противном случае, иначе
hint	подсказывать, намекать
contribute	способствовать, вносить вклад
sofa	диван
carpet	ковер
competitors	конкуренты
rival	соперник
halves	половинки
further	дальше
conclusion	вывод
jealous	ревнивый, завистливый
invent	изобретать, выдумывать
tan	загар
frighten	пугать
bench	скамейка
dumbbell	гантель, гиря
breast	грудь
persuade	уговаривать, убеждать
ancestors	предки
script	сценарий
bias	предвзятость
receipt	чек
upset	расстроенный
refuse	отказаться
near	рядом
internal	внутренний